#########################
#           #           #
#    S      #     E     #
#           #           #
#           #           #
#           #           #
#                       #
#                       #
#                       #
#                       #
#########################
