#####################
S       #   #   #   #
####### # # # # # # #
#   #   # #   #   # #
# # # ### ######### #
# #   #   #         #
# ##### ### #########
#   #   #     #     #
### # ### ##### #####
#   # # # #   #     #
# ### # # # # ##### #
#   #   # # #       #
# # # ### # #########
# #   #   #     #   #
# ##### ##### # ### #
#     #       #   # #
##### ### ##### # # #
#     #   #     #   #
# ##### #############
#     #             E
#####################
