****************
*S   *         *
*    *    *  ***
*    *    *    *
*    *    *    *
*    *    *    *
*         *   E*
****************
